##########
#........#
#....#####
#....#####
#....#####
#....#####
#....#####
#....#####
#....#####
##########